G G R G G W G G G G G G G G G G G G G G
G G R G G W G G G G G T G G G G G G G G
G G R G G W G G G G G R G G G G G G G G
G G R G G W G G G G G R G G G G G G G G
G G R G G W G G G G G R G G G G G G G G
G G R G G W G G G G G R G G G G G G G G
G G R G G G G G G G G R G G G G G G W W
G G R G G G G G R R R R R R R G G G W G
G G R R R R R R R G G G G G R G W W W G
G G G G G G G G G G G G W G R R R R R R
G G G G G G G G G G G W W W G W W G G G
G G G G G G G G G G W W W W W W G G G G
G G G G G G G G G G G W W W G G G G G G
G G G G G G G G G G G G W G G G G G G G
G G G G G G G G G G G G G G G G G G G G 